int[][] map1 = new int [][] {
       	{0, 5, 5, 10, 10, 10, 10, 10, 10, 10, 10, 10, 10, 10, 10 },
       	{5, 0, 5, 10, 10, 10, 10, 10, 10, 10, 10, 10, 10, 10, 10 },
       	{5, 5, 0, 5, 5, 10, 10, 10, 10, 5, 10, 5, 10, 10, 10 },
       	{10, 10, 5, 2, 10, 10, 10, 10, 10, 10, 10, 10, 10, 10, 10 },
       	{10, 10, 5, 10, 0, 5, 10, 10, 10, 10, 10, 10, 10, 10, 10 },
       	{10, 10, 10, 10, 5, 0, 5, 5, 10, 10, 10, 10, 10, 10, 10 },
       	{10, 10, 10, 10, 10, 5, 0, 10, 10, 10, 5, 10, 10, 10, 10 },
       	{10, 10, 10, 10, 10, 5, 10, 0, 5, 5, 5, 10, 10, 10, 10 },
       	{10, 10, 10, 10, 10, 10, 10, 5, 0, 5, 10, 10, 10, 10, 10 },
       	{10, 10, 5, 10, 10, 10, 10, 5, 5, 0, 10, 5, 5, 10, 10 },
       	{10, 10, 10, 10, 10, 10, 5, 5, 10, 10, 0, 10, 10, 5, 10 },
       	{10, 10, 5, 10, 10, 10, 10, 10, 10, 5, 10, 0, 10, 10, 5 },
       	{10, 10, 10, 10, 10, 10, 10, 10, 10, 5, 10, 10, 0, 5, 10 },
       	{10, 10, 10, 10, 10, 10, 10, 10, 10, 10, 5, 10, 5, 8, 10 },
       	{10, 10, 10, 10, 10, 10, 10, 10, 10, 10, 10, 5, 10, 10, 0 }
       	};
       	
int[][] map2 = new int [][] {
       {0, 5, 5, 10, 10, 10, 10, 10, 10, 10, 10, 10, 10, 10, 10}, 
       {5, 0, 5, 10, 10, 10, 10, 10, 10, 10, 10, 10, 10, 10, 10}, 
       {5, 5, 0, 5, 5, 10, 10, 10, 10, 5, 10, 5, 10, 10, 10}, 
       {10, 10, 5, 2, 10, 10, 10, 10, 10, 10, 10, 10, 10, 10, 10}, 
       {10, 10, 5, 10, 0, 10, 10, 10, 10, 10, 10, 10, 10, 10, 10}, 
       {10, 10, 10, 10, 10, 8, 5, 5, 10, 10, 10, 10, 10, 10, 10}, 
       {10, 10, 10, 10, 10, 5, 0, 10, 10, 10, 5, 10, 10, 10, 10}, 
       {10, 10, 10, 10, 10, 5, 10, 0, 5, 5, 5, 10, 10, 10, 10}, 
       {10, 10, 10, 10, 10, 10, 10, 5, 0, 5, 10, 10, 10, 10, 10}, 
       {10, 10, 5, 10, 10, 10, 10, 5, 5, 0, 10, 5, 5, 10, 10}, 
       {10, 10, 10, 10, 10, 10, 5, 5, 10, 10, 0, 10, 10, 5, 10}, 
       {10, 10, 5, 10, 10, 10, 10, 10, 10, 5, 10, 0, 10, 10, 5}, 
       {10, 10, 10, 10, 10, 10, 10, 10, 10, 5, 10, 10, 0, 5, 10}, 
       {10, 10, 10, 10, 10, 10, 10, 10, 10, 10, 5, 10, 5, 0, 10}, 
       {10, 10, 10, 10, 10, 10, 10, 10, 10, 10, 10, 5, 10, 10, 0}
       };
        
int[][] map3 = new int [][] {	
       {0, 5, 5, 10, 10, 10, 10, 10, 10, 10, 10, 10, 10, 10, 10},
       {5, 0, 5, 10, 10, 10, 10, 10, 10, 10, 10, 10, 10, 10, 10},
       {5, 5, 0, 5, 5, 10, 10, 10, 10, 5, 10, 5, 10, 10, 10},
       {10, 10, 5, 2, 10, 10, 10, 10, 10, 10, 10, 10, 10, 10, 10},
       {10, 10, 5, 10, 0, 5, 10, 10, 10, 10, 10, 10, 10, 10, 10},
       {10, 10, 10, 10, 5, 0, 5, 5, 10, 10, 10, 10, 10, 10, 10},
       {10, 10, 10, 10, 10, 5, 0, 10, 10, 10, 5, 10, 10, 10, 10},
       {10, 10, 10, 10, 10, 5, 10, 0, 5, 5, 5, 10, 10, 10, 10},
       {10, 10, 10, 10, 10, 10, 10, 5, 0, 5, 10, 10, 10, 10, 10},
       {10, 10, 5, 10, 10, 10, 10, 5, 5, 0, 10, 5, 5, 10, 10},
       {10, 10, 10, 10, 10, 10, 5, 5, 10, 10, 0, 10, 10, 5, 10},
       {10, 10, 5, 10, 10, 10, 10, 10, 10, 5, 10, 0, 10, 10, 10},
       {10, 10, 10, 10, 10, 10, 10, 10, 10, 5, 10, 10, 0, 5, 10},
       {10, 10, 10, 10, 10, 10, 10, 10, 10, 10, 5, 10, 5, 0, 10},
       {10, 10, 10, 10, 10, 10, 10, 10, 10, 10, 10, 10, 10, 10, 8}
       };
       
int[][] map4 = new int [][] {	
       {2, 5, 5, 10, 10, 5, 10, 10, 10, 10, 10, 10, 10, 10, 10},
       {5, 0, 5, 10, 5, 10, 10, 10, 10, 10, 10, 10, 10, 10, 10},
       {5, 5, 0, 5, 5, 10, 10, 10, 5, 5, 10, 5, 10, 10, 10},
       {10, 10, 5, 0, 10, 10, 10, 10, 10, 10, 10, 5, 10, 10, 5},
       {10, 5, 5, 10, 0, 5, 10, 5, 10, 10, 10, 10, 10, 10, 10},
       {5, 10, 10, 10, 5, 0, 5, 5, 10, 10, 10, 10, 10, 10, 10},
       {10, 10, 10, 10, 10, 5, 0, 10, 10, 10, 5, 10, 10, 10, 10},
       {10, 10, 10, 10, 5, 5, 10, 0, 5, 5, 5, 10, 10, 10, 10},
       {10, 10, 5, 10, 10, 10, 10, 5, 0, 5, 10, 5, 10, 5, 10},
       {10, 10, 5, 10, 10, 10, 10, 5, 5, 0, 10, 5, 5, 10, 10},
       {10, 10, 10, 10, 10, 10, 5, 5, 10, 10, 0, 10, 10, 5, 10},
       {10, 10, 5, 5, 10, 10, 10, 10, 5, 5, 10, 0, 10, 10, 10},
       {10, 10, 10, 10, 10, 10, 10, 10, 10, 5, 10, 10, 8, 5, 5},
       {10, 10, 10, 10, 10, 10, 10, 10, 5, 10, 5, 10, 5, 0, 5},
       {10, 10, 10, 5, 10, 10, 10, 10, 10, 10, 10, 10, 5, 5, 0}
       };
       
int[][] map5 = new int [][] {	
       {0, 5, 5, 10, 10, 10, 10, 10, 10, 10, 10, 10, 10, 10, 10},
       {5, 0, 5, 10, 10, 10, 10, 10, 10, 10, 10, 10, 10, 10, 10},
       {5, 5, 0, 5, 5, 10, 10, 10, 10, 10, 10, 5, 10, 10, 10},
       {10, 10, 5, 2, 10, 10, 10, 10, 10, 10, 10, 10, 10, 10, 10},
       {10, 10, 5, 10, 0, 5, 10, 10, 10, 10, 10, 10, 10, 10, 10},
       {10, 10, 10, 10, 5, 0, 5, 5, 10, 10, 10, 10, 10, 10, 10},
       {10, 10, 10, 10, 10, 5, 0, 10, 10, 10, 10, 10, 10, 10, 10},
       {10, 10, 10, 10, 10, 5, 10, 0, 5, 10, 5, 10, 10, 10, 10},
       {10, 10, 10, 10, 10, 10, 10, 5, 0, 5, 10, 10, 10, 10, 10},
       {10, 10, 10, 10, 10, 10, 10, 10, 5, 0, 10, 10, 5, 10, 10},
       {10, 10, 10, 10, 10, 10, 10, 5, 10, 10, 0, 10, 10, 5, 10},
       {10, 10, 5, 10, 10, 10, 10, 10, 10, 10, 10, 0, 10, 10, 5},
       {10, 10, 10, 10, 10, 10, 10, 10, 10, 5, 10, 10, 0, 5, 10},
       {10, 10, 10, 10, 10, 10, 10, 10, 10, 10, 5, 10, 5, 8, 10},
       {10, 10, 10, 10, 10, 10, 10, 10, 10, 10, 10, 5, 10, 10, 0}
       };
       
int[][] map6 = new int [][] {	
       	{2, 5, 10, 10, 5, 10, 10},
       	{5, 0, 5, 10, 10, 10, 10},
       	{10, 5, 0, 5, 10, 10, 10},
       	{10, 10, 5, 8, 10, 10, 5},
       	{5, 10, 10, 10, 0, 5, 10},
       	{10, 10, 10, 10, 5, 0, 5},
       	{10, 10, 10, 5, 10, 5, 0}
	};
       	
int[][] map7 = new int [][] {	
       {0, 5, 10, 10, 10, 10, 10},
       {5, 0, 5, 10, 10, 10, 10},
       {10, 5, 2, 5, 10, 10, 10},
       {10, 10, 5, 0, 10, 10, 5},
       {10, 10, 10, 10, 8, 10, 10},
       {10, 10, 10, 10, 10, 0, 5},
       {10, 10, 10, 5, 10, 5, 0}
       };
       
int[][] map8 = new int [][] {	
       {0, 5, 10, 10, 5, 10, 10, 10, 10, 10, 10, 10, 10, 10, 10, 10},
       {5, 8, 5, 10, 10, 5, 10, 10, 10, 10, 10, 10, 10, 10, 10, 10},
       {10, 5, 0, 5, 10, 10, 5, 10, 10, 10, 10, 10, 10, 10, 10, 10},
       {10, 10, 5, 0, 10, 10, 10, 5, 10, 10, 10, 10, 10, 10, 10, 10},
       {5, 10, 10, 10, 0, 5, 10, 10, 5, 10, 10, 10, 10, 10, 10, 10},
       {10, 5, 10, 10, 5, 0, 5, 10, 10, 5, 10, 10, 10, 10, 10, 10},
       {10, 10, 5, 10, 10, 5, 0, 5, 10, 10, 5, 10, 10, 10, 10, 10},
       {10, 10, 10, 5, 10, 10, 5, 0, 10, 10, 10, 5, 10, 10, 10, 10},
       {10, 10, 10, 10, 5, 10, 10, 10, 0, 5, 10, 10, 5, 10, 10, 10},
       {10, 10, 10, 10, 10, 5, 10, 10, 5, 0, 5, 10, 10, 5, 10, 10},
       {10, 10, 10, 10, 10, 10, 5, 10, 10, 5, 0, 5, 10, 10, 5, 10},
       {10, 10, 10, 10, 10, 10, 10, 5, 10, 10, 5, 0, 10, 10, 10, 5},
       {10, 10, 10, 10, 10, 10, 10, 10, 5, 10, 10, 10, 0, 5, 10, 10},
       {10, 10, 10, 10, 10, 10, 10, 10, 10, 5, 10, 10, 5, 0, 5, 10},
       {10, 10, 10, 10, 10, 10, 10, 10, 10, 10, 5, 10, 10, 5, 2, 5},
       {10, 10, 10, 10, 10, 10, 10, 10, 10, 10, 10, 5, 10, 10, 5, 0}
       };
       
int[][] map9 = new int [][] {
       {0, 5, 10, 10, 5, 10, 10, 10, 10, 10, 10, 10, 10, 10, 10, 10},
       {5, 0, 5, 10, 10, 5, 10, 10, 10, 10, 10, 10, 10, 10, 10, 10},
       {10, 5, 0, 5, 10, 10, 5, 10, 10, 10, 10, 10, 10, 10, 10, 10},
       {10, 10, 5, 0, 10, 10, 10, 5, 10, 10, 10, 10, 10, 10, 10, 10},
       {5, 10, 10, 10, 0, 5, 10, 10, 5, 10, 10, 10, 10, 10, 10, 10},
       {10, 5, 10, 10, 5, 0, 10, 10, 10, 5, 10, 10, 10, 10, 10, 10},
       {10, 10, 5, 10, 10, 10, 0, 5, 10, 10, 5, 10, 10, 10, 10, 10},
       {10, 10, 10, 5, 10, 10, 5, 2, 10, 10, 10, 5, 10, 10, 10, 10},
       {10, 10, 10, 10, 5, 10, 10, 10, 0, 5, 10, 10, 5, 10, 10, 10},
       {10, 10, 10, 10, 10, 5, 10, 10, 5, 8, 10, 10, 10, 10, 10, 10},
       {10, 10, 10, 10, 10, 10, 5, 10, 10, 10, 0, 5, 10, 10, 5, 10},
       {10, 10, 10, 10, 10, 10, 10, 5, 10, 10, 5, 0, 10, 10, 10, 5},
       {10, 10, 10, 10, 10, 10, 10, 10, 5, 10, 10, 10, 0, 5, 10, 10},
       {10, 10, 10, 10, 10, 10, 10, 10, 10, 10, 10, 10, 5, 0, 5, 10},
       {10, 10, 10, 10, 10, 10, 10, 10, 10, 10, 5, 10, 10, 5, 0, 5},
       {10, 10, 10, 10, 10, 10, 10, 10, 10, 10, 10, 5, 10, 10, 5, 0}
       };